,rank,title,world,domestic,dom %,foreign,for %,year
0,1,inside out 2,1698217953,652980194,38.5,1045237759,61.5,2024
1,2,deadpool & wolverine,1337900827,636745858,47.6,701154969,52.4,2024
2,3,despicable me 4,968240710,361004205,37.3,607236505,62.7,2024
3,4,dune: part two,714444358,282144358,39.5,432300000,60.5,2024
4,5,godzilla x kong: the new empire,571750016,196350016,34.3,375400000,65.7,2024
5,6,kung fu panda 4,547634675,193590620,35.4,354044055,64.6,2024
6,7,beetlejuice beetlejuice,451037988,294037988,65.2,157000000,34.8,2024
7,8,venom: the last dance,436594490,128094490,29.3,308500000,70.7,2024
8,9,bad boys: ride or die,404509070,193573217,47.9,210935853,52.1,2024
9,10,kingdom of the planet of the apes,397378150,171130165,43.1,226247985,56.9,2024
10,11,twisters,370962265,267762265,72.2,103200000,27.8,2024
11,12,alien: romulus,350861031,105313091,30.0,245547940,70.0,2024
12,13,it ends with us,349473789,148518266,42.5,200955523,57.5,2024
13,14,the wild robot,309056995,137913995,44.6,171143000,55.4,2024
14,15,a quiet place: day one,261786322,138930553,53.1,122855769,46.9,2024
15,16,the garfield movie,236277526,91956547,38.9,144320979,61.1,2024
16,17,joker: folie à deux,206400287,58300287,28.2,148100000,71.8,2024
17,18,ghostbusters: frozen empire,201856657,113376590,56.2,88480067,43.8,2024
18,19,if,190309707,111149917,58.4,79159790,41.6,2024
19,20,the fall guy,181073291,92900355,51.3,88172936,48.7,2024
20,21,bob marley: one love,180828556,96893170,53.6,83935386,46.4,2024
21,22,furiosa: a mad max saga,173775791,67475791,38.8,106300000,61.2,2024
22,23,the beekeeper,152720535,66220535,43.4,86500000,56.6,2024
23,24,smile 2,132084546,65884546,49.9,66200000,50.1,2024
24,25,transformers one,128876166,59042233,45.8,69833933,54.2,2024
25,26,civil war,126185957,68603430,54.4,57582527,45.6,2024
26,27,longlegs,126176363,74346140,58.9,51830223,41.1,2024
27,28,detective conan: the million-dollar pentagram,108136957,0,0.0,108136957,100.0,2024
28,29,mean girls,104793431,72404248,69.1,32389183,30.9,2024
29,30,madame web,100498764,43817106,43.6,56681658,56.4,2024
30,31,haikyu!! the dumpster battle,100255784,7071622,7.1,93184162,92.9,2024
31,32,exhuma,97981310,2310900,2.4,95670410,97.6,2024
32,33,argylle,96221061,45207275,47.0,51013786,53.0,2024
33,34,challengers,96019408,50119408,52.2,45900000,47.8,2024
34,35,gladiator ii,87000000,0,0.0,87000000,100.0,2024
35,36,terrifier 3,85376954,53981071,63.2,31395883,36.8,2024
36,37,red one,84870372,33770372,39.8,51100000,60.2,2024
37,38,a little something extra,84035239,0,0.0,84035239,100.0,2024
38,39,the roundup: punishment,83703350,1154475,1.4,82548875,98.6,2024
39,40,trap,82677281,42777281,51.7,39900000,48.3,2024
40,41,speak no evil,76743256,36931420,48.1,39811836,51.9,2024
41,42,the count of monte-cristo,76301696,0,0.0,76301696,100.0,2024
42,43,night swim,54768317,32494740,59.3,22273577,40.7,2024
43,44,kingdom 4: return of the great general,54099198,0,0.0,54099198,100.0,2024
44,45,the first omen,53845880,20092802,37.3,33753078,62.7,2024
45,46,"i, the executioner",53453611,388067,0.7,53065544,99.3,2024
46,47,coraline 15th anniversary,52371887,33626425,64.2,18745462,35.8,2024
47,48,the substance,51463372,16235191,31.5,35228181,68.5,2024
48,49,back to black,50890837,6157705,12.1,44733132,87.9,2024
49,50,tarot,49256239,18771004,38.1,30485235,61.9,2024
50,51,the strangers: chapter 1,47803285,35202562,73.6,12600723,26.4,2024
51,52,blink twice,46393906,23093906,49.8,23300000,50.2,2024
52,53,demon slayer: kimetsu no yaiba - to the hashira training,44354825,17657658,39.8,26697167,60.2,2024
53,54,imaginary,43787034,28009161,64.0,15777873,36.0,2024
54,55,abigail,42789989,25867515,60.5,16922474,39.5,2024
55,56,fly me to the moon,42225354,20532222,48.6,21693132,51.4,2024
56,57,arthur the king,40829138,25049006,61.4,15780132,38.6,2024
57,58,the forge,40216265,29108124,72.4,11108141,27.6,2024
58,59,horizon: an american saga - chapter 1,38235702,29035702,75.9,9200000,24.1,2024
59,60,last mile,37164152,0,0.0,37164152,100.0,2024
60,61,mobile suit gundam seed freedom,36038764,0,0.0,36038764,100.0,2024
61,62,the bikeriders,35971858,21714630,60.4,14257228,39.6,2024
62,63,monkey man,35271631,25116955,71.2,10154676,28.8,2024
63,64,doraemon the movie: nobita's earth symphony,33399912,0,0.0,33399912,100.0,2024
64,65,the watchers,33271404,19071404,57.3,14200000,42.7,2024
65,66,borderlands,32978510,15482668,46.9,17495842,53.1,2024
66,67,pilot,31836387,0,0.0,31836387,100.0,2024
67,68,harold and the purple crayon,31793044,17640924,55.5,14152120,44.5,2024
68,69,my hero academia: you're next,31677713,5041781,15.9,26635932,84.1,2024
69,70,a strange house,30864331,0,0.0,30864331,100.0,2024
70,71,reagan,30107173,30047417,99.8,59756,0.2,2024
71,72,the dark knight rises 2024 re-release,29685650,0,0.0,29685650,100.0,2024
72,73,chantal in fairyland,29671107,0,0.0,29671107,100.0,2024
73,74,we live in time,28916122,23932392,82.8,4983730,17.2,2024
74,75,immaculate,28454578,15671307,55.1,12783271,44.9,2024
75,76,conclave,28067322,26813110,95.5,1254212,4.5,2024
76,77,the master and margarita,27989335,0,0.0,27989335,100.0,2024
77,78,wicked little letters,27219729,5008179,18.4,22211550,81.6,2024
78,79,beating hearts,27189464,0,0.0,27189464,100.0,2024
79,80,the ministry of ungentlemanly warfare,26974933,20535053,76.1,6439880,23.9,2024
80,81,interstellar 2024 re-release,25808559,0,0.0,25808559,100.0,2024
81,82,heretic,25455477,20436947,80.3,5018530,19.7,2024
82,83,kalki 2898 ad,25331927,18289575,72.2,7042352,27.8,2024
83,84,the crow,23999106,9275659,38.7,14723447,61.3,2024
84,85,school of magical animals 3,23269694,0,0.0,23269694,100.0,2024
85,86,maxxxine,22056816,15097632,68.4,6959184,31.6,2024
86,87,mai,21714524,0,0.0,21714524,100.0,2024
87,88,lee,21617781,1993936,9.2,19623845,90.8,2024
88,89,autumn and the black jaguar,21500583,0,0.0,21500583,100.0,2024
89,90,unsung hero,21214331,20335239,95.9,879092,4.1,2024
90,91,lyod 3,20615744,0,0.0,20615744,100.0,2024
91,92,ordinary angels,20571534,19174421,93.2,1397113,6.8,2024
92,93,cabrini,20460915,19512134,95.4,948781,4.6,2024
93,94,the best christmas pageant ever,20235489,20235489,100.0,0,0.0,2024
94,95,anora,19780629,10643274,53.8,9137355,46.2,2024
95,96,"la planète des singes, une odyssée de l'espèce",19515102,0,0.0,19515102,100.0,2024
96,97,star wars: episode i - the phantom menace 2024 re-release,19429994,13029994,67.1,6400000,32.9,2024
97,98,face off 7: one wish,19353760,0,0.0,19353760,100.0,2024
98,99,golden kamuy,19077748,0,0.0,19077748,100.0,2024
99,100,crayon shin-chan: ora's dinosaur diary,19017879,0,0.0,19017879,100.0,2024
100,101,escape,18456373,259242,1.4,18197131,98.6,2024
101,102,cocorico,18266308,0,0.0,18266308,100.0,2024
102,103,twilight of the warriors: walled in,17111121,336023,2.0,16775098,98.0,2024
103,104,never let go,16411324,10306106,62.8,6105218,37.2,2024
104,105,kinds of kindness,16398509,5038931,30.7,11359578,69.3,2024
105,106,guest from the future,15900290,0,0.0,15900290,100.0,2024
106,107,10 lives,15654945,0,0.0,15654945,100.0,2024
107,108,late night with the devil,15453763,10001000,64.7,5452763,35.3,2024
108,109,kleks academy,15348026,0,0.0,15348026,100.0,2024
109,110,the chosen: s4 episodes 1-3,14873918,14409169,96.9,464749,3.1,2024
110,111,father there is only one 4,14668098,0,0.0,14668098,100.0,2024
111,112,hijack 1971,14596787,242069,1.7,14354718,98.3,2024
112,113,handsome guys,14439610,0,0.0,14439610,100.0,2024
113,114,blue lock: episode nagi,14291561,1855384,13.0,12436177,87.0,2024
114,115,megalopolis,13734042,7629085,55.5,6104957,44.5,2024
115,116,article 370,13222021,1088790,8.2,12133231,91.8,2024
116,117,afraid,12977758,6725687,51.8,6252071,48.2,2024
117,118,letuchiy korabl,12886684,0,0.0,12886684,100.0,2024
118,119,love lies bleeding,12777925,8335797,65.2,4442128,34.8,2024
119,120,look back,12561337,1986415,15.8,10574922,84.2,2024
120,121,paddington in peru,12467357,0,0.0,12467357,100.0,2024
121,122,here,12314793,11714515,95.1,600278,4.9,2024
122,123,am i racist?,12311598,12311598,100.0,0,0.0,2024
123,124,thelma,11983083,9002073,75.1,2981010,24.9,2024
124,125,citizen of a kind,11976305,0,0.0,11976305,100.0,2024
125,126,the apprentice,11903308,3989759,33.5,7913549,66.5,2024
126,127,sound of hope: the story of possum trot,11721425,11647099,99.4,74326,0.6,2024
127,128,maison de retraite 2,11227393,0,0.0,11227393,100.0,2024
128,129,a million minutes,11077140,0,0.0,11077140,100.0,2024
129,130,alienoid: the return to the future,10824208,60720,0.6,10763488,99.4,2024
130,131,the lord of the rings: the return of the king 2024 re-release,10804596,2450927,22.7,8353669,77.3,2024
131,132,jung kook: i am still,10763217,2574318,23.9,8188899,76.1,2024
132,133,cat and dog,10740923,0,0.0,10740923,100.0,2024
133,134,monsieur aznavour,10413337,0,0.0,10413337,100.0,2024
134,135,mrs. green apple: the white lounge,10283462,0,0.0,10283462,100.0,2024
135,136,the enchanted tinderbox,10253794,0,0.0,10253794,100.0,2024
136,137,all about suomi,10176530,0,0.0,10176530,100.0,2024
137,138,piece by piece,10129480,9756635,96.3,372845,3.7,2024
138,139,lisa frankenstein,9927714,9774285,98.5,153429,1.5,2024
139,140,muroi shinji: yaburezaru mono,9741343,0,0.0,9741343,100.0,2024
140,141,saturday night,9722454,9497388,97.7,225066,2.3,2024
141,142,the exorcism,9659440,4530418,46.9,5129022,53.1,2024
142,143,juror #2,9600000,0,0.0,9600000,100.0,2024
143,144,the chosen: s4 episodes 4-6,9482744,9482744,100.0,0,0.0,2024
144,145,ruki vverkh!,9319216,0,0.0,9319216,100.0,2024
145,146,a smile doesn't lie,9211570,0,0.0,9211570,100.0,2024
146,147,onegin,9201680,0,0.0,9201680,100.0,2024
147,148,abudeka is back,9163586,0,0.0,9163586,100.0,2024
148,149,lohusa,8809952,0,0.0,8809952,100.0,2024
149,150,following,8793810,0,0.0,8793810,100.0,2024
150,151,uma musume: pretty derby - beginning of a new era,8551637,0,0.0,8551637,100.0,2024
151,152,dear family,8528605,0,0.0,8528605,100.0,2024
152,153,white bird,8522806,5069171,59.5,3453635,40.5,2024
153,154,emilia pérez,8495918,0,0.0,8495918,100.0,2024
154,155,un mondo a parte,8108856,0,0.0,8108856,100.0,2024
155,156,the birth of korea,8022137,0,0.0,8022137,100.0,2024
156,157,drive-away dolls,7935363,5028215,63.4,2907148,36.6,2024
157,158,heartsping : teenieping of love,7922487,0,0.0,7922487,100.0,2024
158,159,the chosen: s4 episodes 7-8,7768191,7729152,99.5,39039,0.5,2024
159,160,ducobu passe au vert!,7510050,0,0.0,7510050,100.0,2024
160,161,buffalo kids,7430948,0,0.0,7430948,100.0,2024
161,162,stree 2,7387498,2570000,34.8,4817498,65.2,2024
162,163,devara part 1,7361414,5600000,76.1,1761414,23.9,2024
163,164,overlord: the sacred kingdom,7352896,1589973,21.6,5762923,78.4,2024
164,165,kolpaçino 4 4'lük,7343114,0,0.0,7343114,100.0,2024
165,166,lim young woong: im hero the stadium,7305588,0,0.0,7305588,100.0,2024
166,167,yolo,7241561,2001584,27.6,5239977,72.4,2024
167,168,sight,7206741,7206741,100.0,0,0.0,2024
168,169,land of bad,7021101,4620045,65.8,2401056,34.2,2024
169,170,wonderful precure! the movie! doki doki game no sekai de daiboken,6975298,0,0.0,6975298,100.0,2024
170,171,undercover,6801080,0,0.0,6801080,100.0,2024
171,172,suga: agust d tour 'd-day' the movie,6791851,1951896,28.7,4839955,71.3,2024
172,173,moshimo tokugawa ieyasu ga souridaijin ni nattara,6760259,0,0.0,6760259,100.0,2024
173,174,"april, come she will",6719810,0,0.0,6719810,100.0,2024
174,175,parthenope,6684669,0,0.0,6684669,100.0,2024
175,176,cuckoo,6680396,6217733,93.1,462663,6.9,2024
176,177,troll factory,6676327,0,0.0,6676327,100.0,2024
177,178,baghead,6671780,0,0.0,6671780,100.0,2024
178,179,waves,6625697,0,0.0,6625697,100.0,2024
179,180,i.s.s.,6605079,6573799,99.5,31280,0.5,2024
180,181,n'avoue jamais,6510619,0,0.0,6510619,100.0,2024
181,182,project silence,6283415,0,0.0,6283415,100.0,2024
182,183,columbia 100th anniversary series columbia 100th anniversary series,6216473,6013515,96.7,0,0.0,2024
183,184,the book of clarence,6205230,6132813,98.8,72417,1.2,2024
184,185,dragonkeeper,6192816,805091,13.0,5387725,87.0,2024
185,186,major grom: the game,6136190,0,0.0,6136190,100.0,2024
186,187,the nightmare before christmas 2024 re-release,6124784,6124705,100.0,79,0.0,2024
187,188,someone like you,5937306,5937306,100.0,0,0.0,2024
188,189,the killer's game,5928351,5404378,91.2,523973,8.8,2024
189,190,love in the big city,5812147,0,0.0,5812147,100.0,2024
190,191,odio el verano,5792673,0,0.0,5792673,100.0,2024
191,192,force of nature: the dry 2,5786313,58690,1.0,5727623,99.0,2024
192,193,my old ass,5708312,5372282,94.1,336030,5.9,2024
193,194,the room next door,5600000,0,0.0,5600000,100.0,2024
194,195,rembob'ina: le comte de monte-cristo,5560681,0,0.0,5560681,100.0,2024
195,196,moonzy. homecoming,5472352,0,0.0,5472352,100.0,2024
196,197,air,5466289,0,0.0,5466289,100.0,2024
197,198,singham again,5387631,2190000,40.6,3197631,59.4,2024
198,199,i saw the tv glow,5383484,5017817,93.2,365667,6.8,2024
199,200,hit man,5348633,0,0.0,5348633,100.0,2024
200,1,barbie,1446938421,636238421,44.0,810700000,56.0,2023
201,2,the super mario bros. movie,1362566989,574934330,42.2,787632659,57.8,2023
202,3,oppenheimer,975594978,329862540,33.8,645732438,66.2,2023
203,4,guardians of the galaxy vol. 3,845555777,358995815,42.5,486559962,57.5,2023
204,5,fast x,704875015,146126015,20.7,558749000,79.3,2023
205,6,spider-man: across the spider-verse,690542303,381311319,55.2,309230984,44.8,2023
206,7,full river red,670491959,0,0.0,670491959,100.0,2023
207,8,wonka,634402312,218402312,34.4,416000000,65.6,2023
208,9,the wandering earth ii,615023132,5023132,0.8,610000000,99.2,2023
209,10,mission: impossible - dead reckoning part one,570619838,172135383,30.2,398484455,69.8,2023
210,11,the little mermaid,569626289,298172056,52.3,271454233,47.7,2023
211,12,no more bets,532600264,0,0.0,532600264,100.0,2023
212,13,elemental,496444308,154426697,31.1,342017611,68.9,2023
213,14,lost in the stars,487661235,1721446,0.4,485939789,99.6,2023
214,15,ant-man and the wasp: quantumania,476071180,214504909,45.1,261566271,54.9,2023
215,16,transformers: rise of the beasts,441381193,157066392,35.6,284314801,64.4,2023
216,17,john wick: chapter 4,440180275,187131806,42.5,253048469,57.5,2023
217,18,aquaman and the lost kingdom,439381226,124481226,28.3,314900000,71.7,2023
218,19,meg 2: the trench,397800317,82600317,20.8,315200000,79.2,2023
219,20,indiana jones and the dial of destiny,383963057,174480468,45.4,209482589,54.6,2023
220,21,creation of the gods i: kingdom of storms,373021923,1706355,0.5,371315568,99.5,2023
221,22,the hunger games: the ballad of songbirds & snakes,348900019,166350594,47.7,182549425,52.3,2023
222,23,never say never,301957043,0,0.0,301957043,100.0,2023
223,24,migration,299863204,127306285,42.5,172556919,57.5,2023
224,25,five nights at freddy's,291493620,137275620,47.1,154218000,52.9,2023
225,26,creed iii,276148615,156248615,56.6,119900000,43.4,2023
226,27,the flash,271433313,108133313,39.8,163300000,60.2,2023
227,28,the nun ii,269667073,86267073,32.0,183400000,68.0,2023
228,29,taylor swift: the eras tour,261656269,180756269,69.1,80900000,30.9,2023
229,30,wish,254997360,63973821,25.1,191023539,74.9,2023
230,31,sound of freedom,250570396,184178046,73.5,66392350,26.5,2023
231,32,napoleon,221394838,61524375,27.8,159870463,72.2,2023
232,33,anyone but you,220297199,88319668,40.1,131977531,59.9,2023
233,34,trolls band together,209372790,102996915,49.2,106375875,50.8,2023
234,35,the marvels,206136825,84500223,41.0,121636602,59.0,2023
235,36,dungeons & dragons: honor among thieves,205187763,93277026,45.5,111910737,54.5,2023
236,37,paw patrol: the mighty movie,204986920,65231360,31.8,139755560,68.2,2023
237,38,the equalizer 3,191067560,92373751,48.3,98693809,51.7,2023
238,39,insidious: the red door,189086877,82156962,43.4,106929915,56.6,2023
239,40,teenage mutant ninja turtles: mutant mayhem,181848832,118613586,65.2,63235246,34.8,2023
240,41,the boy and the heron,173134438,46832867,27.1,126301571,72.9,2023
241,42,scream vi,166347514,108161389,65.0,58186125,35.0,2023
242,43,killers of the flower moon,158764012,68026901,42.8,90737111,57.2,2023
243,44,evil dead rise,147033054,67233054,45.7,79800000,54.3,2023
244,45,the exorcist: believer,136294607,65537395,48.1,70757212,51.9,2023
245,46,shazam! fury of the gods,134138006,57638006,43.0,76500000,57.0,2023
246,47,blue beetle,130788072,72488072,55.4,58300000,44.6,2023
247,48,a haunting in venice,122290456,42471412,34.7,79819044,65.3,2023
248,49,gran turismo,122076738,44428554,36.4,77648184,63.6,2023
249,50,poor things,117625455,34553225,29.4,83072230,70.6,2023
250,51,haunted mansion,117449790,67653287,57.6,49796503,42.4,2023
251,52,godzilla minus one,113676322,57144669,50.3,56531653,49.7,2023
252,53,pathaan,112583450,17487476,15.5,95095974,84.5,2023
253,54,saw x,112202480,53607898,47.8,58594582,52.2,2023
254,55,detective conan: black iron submarine,106771806,0,0.0,106771806,100.0,2023
255,56,the creator,104272136,40774679,39.1,63497457,60.9,2023
256,57,12.12: the day,97476565,0,0.0,97476565,100.0,2023
257,58,animal,92870950,15004482,16.2,77866468,83.8,2023
258,59,talk to me,92181735,48299436,52.4,43882299,47.6,2023
259,60,air,90060106,52460106,58.3,37600000,41.7,2023
260,61,cocaine bear,88314672,64670240,73.2,23644432,26.8,2023
261,62,no hard feelings,87256407,50452282,57.8,36804125,42.2,2023
262,63,the roundup: no way out,83410298,909411,1.1,82500887,98.9,2023
263,64,the pope's exorcist,76987621,20009380,26.0,56978241,74.0,2023
264,65,plane,74515586,32111181,43.1,42404405,56.9,2023
265,66,titanic 25 year anniversary,70157472,15033795,21.4,55123677,78.6,2023
266,67,the color purple,68819191,60619191,88.1,8200000,11.9,2023
267,68,the boogeyman,67307243,43244282,64.2,24062961,35.8,2023
268,69,65,60730568,32062904,52.8,28667664,47.2,2023
269,70,spy x family code: white,59629242,8110042,13.6,51519200,86.4,2023
270,71,magic mike's last dance,57105156,26005156,45.5,31100000,54.5,2023
271,72,one life,56473036,5716885,10.1,50756151,89.9,2023
272,73,demon slayer: kimetsu no yaiba - to the swordsmith village,56319794,10117806,18.0,46201988,82.0,2023
273,74,the boys in the boat,55501365,52641306,94.8,2860059,5.2,2023
274,75,knock at the cabin,54760947,35397980,64.6,19362967,35.4,2023
275,76,mummies,54475970,4275970,7.8,50200000,92.2,2023
276,77,jesus revolution,54295801,52102987,96.0,2192814,4.0,2023
277,78,asteroid city,53857743,28153025,52.3,25704718,47.7,2023
278,79,the zone of interest,52798026,8659464,16.4,44138562,83.6,2023
279,80,there's still tomorrow,49511579,0,0.0,49511579,100.0,2023
280,81,operation fortune: ruse de guerre,48983306,6496125,13.3,42487181,86.7,2023
281,82,missing,48767848,32502025,66.6,16265823,33.4,2023
282,83,thanksgiving,46553280,31908884,68.5,14644396,31.5,2023
283,84,asterix & obelix: the middle kingdom,46497678,0,0.0,46497678,100.0,2023
284,85,ruby gillman: teenage kraken,45657745,15753600,34.5,29904145,65.5,2023
285,86,the holdovers,45635030,20355375,44.6,25279655,55.4,2023
286,87,the iron claw,45204449,35070296,77.6,10134153,22.4,2023
287,88,son of a rich 2,44718015,0,0.0,44718015,100.0,2023
288,89,renaissance: a film by beyoncé,43989684,33889684,77.0,10100000,23.0,2023
289,90,ferrari,43332974,18550028,42.8,24782946,57.2,2023
290,91,past lives,42540332,11185625,26.3,31354707,73.7,2023
291,92,80 for brady,40362938,39330588,97.4,1032350,2.6,2023
292,93,"miraculous: ladybug & cat noir, the movie",40209224,0,0.0,40209224,100.0,2023
293,94,my big fat greek wedding 3,38831076,28496030,73.4,10335046,26.6,2023
294,95,the expendables 4,37917985,16710153,44.1,21207832,55.9,2023
295,96,doraemon the movie: nobita's sky utopia,37475850,0,0.0,37475850,100.0,2023
296,97,smugglers,36851831,0,0.0,36851831,100.0,2023
297,98,kingdom 3: the flame of destiny,36259522,0,0.0,36259522,100.0,2023
298,99,ride on,36258730,128950,0.4,36129780,99.6,2023
299,100,strays,36071267,23988885,66.5,12082382,33.5,2023
300,101,anatomy of a fall,36051506,5076369,14.1,30975137,85.9,2023
301,102,the bremen town musicians,34596570,0,0.0,34596570,100.0,2023
302,103,noryang: deadly sea,34210966,315245,0.9,33895721,99.1,2023
303,104,alibi.com 2,34114308,0,0.0,34114308,100.0,2023
304,105,priscilla,33112062,20960939,63.3,12151123,36.7,2023
305,106,don't call it mystery: the movie,32488540,0,0.0,32488540,100.0,2023
306,107,the three musketeers - part i: d'artagnan,32407471,0,0.0,32407471,100.0,2023
307,108,tokyo mer,30239900,0,0.0,30239900,100.0,2023
308,109,concrete utopia,30077348,0,0.0,30077348,100.0,2023
309,110,bts: yet to come in cinemas,29291883,8093270,27.6,21198613,72.4,2023
310,111,book club: the next chapter,29014500,17581565,60.6,11432935,39.4,2023
311,112,i wish i could meet you again on the hill where that flower blooms (2023),28933626,0,0.0,28933626,100.0,2023
312,113,jawan,28499044,15198530,53.3,13300514,46.7,2023
313,114,the wish of the fairy fish,28218581,0,0.0,28218581,100.0,2023
314,115,toy story 2023 re-release,27508169,0,0.0,27503758,100.0,2023
315,116,renfield,26493921,17297895,65.3,9196026,34.7,2023
316,117,perfect days,25682202,3766668,14.7,21915534,85.3,2023
317,118,gravity 2023 re-release (10th anniversary),24981634,0,0.0,24981634,100.0,2023
318,119,frozen 2023 re-release (sing -a-long),24845502,0,0.0,24845502,100.0,2023
319,120,shin jigen! crayon shin-chan the movie,23920308,0,0.0,23920308,100.0,2023
320,121,the challenge,22683328,0,0.0,22683328,100.0,2023
321,122,american fiction,22483370,21098470,93.8,1384900,6.2,2023
322,123,guy ritchie's the covenant,21948551,16938039,77.2,5010512,22.8,2023
323,124,radical,21828715,8702731,39.9,13125984,60.1,2023
324,125,the last voyage of the demeter,21786275,13637180,62.6,8149095,37.4,2023
325,126,"are you there god? it's me, margaret.",21464043,20372406,94.9,1091637,5.1,2023
326,127,idolish7 movie: live 4bit - beyond the period,21112012,0,0.0,21112012,100.0,2023
327,128,saltburn,21026167,11425829,54.3,9600338,45.7,2023
328,129,dumb money,20703794,13925356,67.3,6761614,32.7,2023
329,130,all of us strangers,20226058,4050103,20.0,16175955,80.0,2023
330,131,my happy marriage,19506407,0,0.0,19506407,100.0,2023
331,132,the house of no man,19490980,0,0.0,19490980,100.0,2023
332,133,champions,19158302,16397335,85.6,2760967,14.4,2023
333,134,retribution,18685751,6937696,37.1,11748055,62.9,2023
334,135,next goal wins,18648802,6713826,36.0,11934976,64.0,2023
335,136,love reset,18425590,0,0.0,18425590,100.0,2023
336,137,the blackening,18169453,17707207,97.5,462246,2.5,2023
337,138,about my father,18167819,12089391,66.5,6078428,33.5,2023
338,139,mavka: the forest song,17974964,0,0.0,17974964,100.0,2023
339,140,the blind,17265876,17265487,100.0,389,0.0,2023
340,141,tokyo revengers 2: bloody halloween - destiny,17216567,0,0.0,17216567,100.0,2023
341,142,hypnotic,16281937,4500169,27.6,11781768,72.4,2023
342,143,the legend & butterfly,16087771,0,0.0,16087771,100.0,2023
343,144,die drei ??? - erbe des drachen,15860016,0,0.0,15860016,100.0,2023
344,145,shin kamen rider,15835414,0,0.0,15835414,100.0,2023
345,146,joy ride,15787674,12897789,81.7,2889885,18.3,2023
346,147,dunki,15473051,7460159,48.2,8012892,51.8,2023
347,148,the three musketeers - part ii: milady,15439299,0,0.0,15439299,100.0,2023
348,149,only 3 days left,15152854,0,0.0,15152854,100.0,2023
349,150,epic tails,15114378,355088,2.3,14759290,97.7,2023
350,151,tonde saitama: biwako yori ai o komete,15107891,0,0.0,15107891,100.0,2023
351,152,a guilty conscience,14911562,0,0.0,14911562,100.0,2023
352,153,tokyo revengers 2: bloody halloween - decisive battle,14584970,0,0.0,14584970,100.0,2023
353,154,dr. cheon and lost talisman,14574445,84362,0.6,14490083,99.4,2023
354,155,jeanne du barry,14365127,0,0.0,14365127,100.0,2023
355,156,sisu,14281199,7265622,50.9,7015577,49.1,2023
356,157,rehragout-rendezvous,14127069,0,0.0,14127069,100.0,2023
357,158,a moroccan affair,14075140,0,0.0,14075140,100.0,2023
358,159,his only son,13817186,12392740,89.7,1424446,10.3,2023
359,160,the point men,13433834,0,0.0,13433834,100.0,2023
360,161,"manta, manta: legacy",13078126,0,0.0,13078126,100.0,2023
361,162,three heroes and the navel of the earth,13028535,0,0.0,13028535,100.0,2023
362,163,bottoms,12976079,12036071,92.8,940008,7.2,2023
363,164,championext,12899042,0,0.0,12899042,100.0,2023
364,165,love again,12696584,6230837,49.1,6465747,50.9,2023
365,166,dream scenario,12502737,5742193,45.9,6760544,54.1,2023
366,167,beau is afraid,12337378,8176562,66.3,4160816,33.7,2023
367,168,the shift,12238643,12118219,99.0,120424,1.0,2023
368,169,salaar,11958548,8929282,74.7,3029266,25.3,2023
369,170,after death,11830860,11478326,97.0,352534,3.0,2023
370,171,tiger 3,11713932,5365263,45.8,6348669,54.2,2023
371,172,jungle bunch: operation meltdown,11594859,831200,7.2,10763659,92.8,2023
372,173,face off 6: the ticket of destiny,11538081,0,0.0,11538081,100.0,2023
373,174,silent night,11067228,8012103,72.4,3055125,27.6,2023
374,175,what's love got to do with it?,11065050,0,0.0,11065050,100.0,2023
375,176,sleep,11063560,34221,0.3,11029339,99.7,2023
376,177,samurai beyond admiration record to the world's best,10876188,0,0.0,10876188,100.0,2023
377,178,honey sweet,10766032,0,0.0,10766032,100.0,2023
378,179,the machine,10664328,10458331,98.1,205997,1.9,2023
379,180,after everything,10644463,0,0.0,10644463,100.0,2023
380,181,the crime is mine,10475796,122083,1.2,10353713,98.8,2023
381,182,the taste of things,10463477,2654510,25.4,7808967,74.6,2023
382,183,the great escaper,10461239,0,0.0,10461239,100.0,2023
383,184,the nightmare before christmas 30th anniversary re-release,10431631,10251956,98.3,179675,1.7,2023
384,185,freelance,10196704,5314136,52.1,4882568,47.9,2023
385,186,sun and concrete,10120340,0,0.0,10120340,100.0,2023
386,187,cobweb,10091821,0,0.0,10091821,100.0,2023
387,188,the peasants,10064347,155188,1.5,9909159,98.5,2023
388,189,talk to her undated france release,9550733,0,0.0,9549770,100.0,2023
389,190,kandahar,9387311,4813132,51.3,4574179,48.7,2023
390,191,house party,9285747,9002247,96.9,283500,3.1,2023
391,192,the animal kingdom,9223124,11767,0.1,9211357,99.9,2023
392,193,all your faces,9065011,0,0.0,9065011,100.0,2023
393,194,cats in the museum,9028318,0,0.0,9028318,100.0,2023
394,195,rafadan tayfa 4: hayrimatör,8945620,0,0.0,8945620,100.0,2023
395,196,father & soldier,8598322,0,0.0,8598322,100.0,2023
396,197,pretty cure all stars f,8557763,0,0.0,8557763,100.0,2023
397,198,dream,8317251,0,0.0,8317251,100.0,2023
398,199,vacaciones de verano,8209854,0,0.0,8209854,100.0,2023
399,200,on the wandering paths,8187567,0,0.0,8187567,100.0,2023
400,1,avatar: the way of water,2320250281,684075767,29.5,1636174514,70.5,2022
401,2,top gun: maverick,1495696292,718732821,48.1,776963471,51.9,2022
402,3,jurassic world dominion,1001978080,376851080,37.6,625127000,62.4,2022
403,4,doctor strange in the multiverse of madness,955775804,411331607,43.0,544444197,57.0,2022
404,5,minions: the rise of gru,940203765,370270765,39.4,569933000,60.6,2022
405,6,black panther: wakanda forever,859208836,453829060,52.8,405379776,47.2,2022
406,7,the batman,772245583,369345583,47.8,402900000,52.2,2022
407,8,thor: love and thunder,760928081,343256830,45.1,417671251,54.9,2022
408,9,water gate bridge,626571697,117294,0.0,626454403,100.0,2022
409,10,puss in boots: the last wish,481757663,186090535,38.6,295667128,61.4,2022
410,11,moon man,460237662,0,0.0,460237662,100.0,2022
411,12,fantastic beasts: the secrets of dumbledore,407150844,95850844,23.5,311300000,76.5,2022
412,13,uncharted,407141258,148648820,36.5,258492438,63.5,2022
413,14,sonic the hedgehog 2,405421518,190872904,47.1,214548614,52.9,2022
414,15,black adam,393452111,168152111,42.7,225300000,57.3,2022
415,16,elvis,287740048,151040048,52.5,136700000,47.5,2022
416,17,the bad guys,250387888,97459240,38.9,152928648,61.1,2022
417,18,bullet train,239268602,103368602,43.2,135900000,56.8,2022
418,19,lightyear,226425420,118307188,52.2,108118232,47.8,2022
419,20,smile,217408513,105935048,48.7,111473465,51.3,2022
420,21,too cool to kill,217254604,185882,0.0,217068722,99.9,2022
421,22,nice view,211019042,0,0.0,211019042,100.0,2022
422,23,dc league of super-pets,207557117,93657117,45.1,113900000,54.9,2022
423,24,the lost city,192907684,105344029,54.6,87563655,45.4,2022
424,25,m3gan,180089109,95159005,52.8,84930104,47.2,2022
425,26,one piece film: red,171315305,12775324,7.5,158539981,92.5,2022
426,27,nope,171235592,123277080,72.0,47958512,28.0,2022
427,28,ticket to paradise,168770985,68275985,40.5,100495000,59.5,2022
428,29,morbius,167460961,73865530,44.1,93595431,55.9,2022
429,30,rrr,165946943,14500000,8.7,151446943,91.3,2022
430,31,the black phone,161440742,90123230,55.8,71317512,44.2,2022
431,32,the first slam dunk,158302288,1291869,0.8,157010419,99.2,2022
432,33,where the crawdads sing,144353965,90230760,62.5,54123205,37.5,2022
433,34,everything everywhere all at once,139407019,77191785,55.4,62215234,44.6,2022
434,35,scream,137743924,81641405,59.3,56102519,40.7,2022
435,36,death on the nile,137307235,45630104,33.2,91677131,66.8,2022
436,37,suzume,133473559,10932037,8.2,122541522,91.8,2022
437,38,a man called otto,113360085,64267657,56.7,49092428,43.3,2022
438,39,"lyle, lyle, crocodile",111080122,46888441,42.2,64191681,57.8,2022
439,40,halloween ends,104374176,64079860,61.4,40294316,38.6,2022
440,41,the roundup,101166707,812859,0.8,100353848,99.2,2022
441,42,the woman king,97562514,67328130,69.0,30234384,31.0,2022
442,43,downton abbey: a new era,92651384,44141550,47.6,48509834,52.4,2022
443,44,k.g.f: chapter 2,89123940,2874000,3.2,86249940,96.8,2022
444,45,don't worry darling,87609403,45309403,51.7,42300000,48.3,2022
445,46,dragon ball super: super hero,86562140,38112140,44.0,48450000,56.0,2022
446,47,dog,84550282,61778069,73.1,22772213,26.9,2022
447,48,jackass forever,80563999,57743451,71.7,22820548,28.3,2022
448,49,the menu,79628200,38501125,48.4,41127075,51.6,2022
449,50,chebi: my fluffy friend,77609926,0,0.0,77609926,100.0,2022
450,51,avatar 2022  re-release,76012917,24714024,32.5,51298893,67.5,2022
451,52,violent night,76004405,50057405,65.9,25947000,34.1,2022
452,53,strange world,73621640,37968963,51.6,35652677,48.4,2022
453,54,detective conan: the bride of halloween,72699093,0,0.0,72699093,100.0,2022
454,55,the northman,69633110,34233110,49.2,35400000,50.8,2022
455,56,moonfall,67319703,19060660,28.3,48234703,71.7,2022
456,57,babylon,64960676,15351455,23.6,49609221,76.4,2022
457,58,whitney houston: i wanna dance with somebody,59806881,23708080,39.6,36098801,60.4,2022
458,59,beast,59095809,31846530,53.9,27249279,46.1,2022
459,60,the whale,57615635,17463630,30.3,39563064,68.7,2022
460,61,hansan: rising dragon,57490985,865888,1.5,56625097,98.5,2022
461,62,confidential assignment 2: international,54486330,0,0.0,54486330,100.0,2022
462,63,ambulance,52303589,22781115,43.6,29522474,56.4,2022
463,64,marry me,50541093,22438180,44.4,28102913,55.6,2022
464,65,the banshees of inisherin,50250625,10582266,21.1,39668359,78.9,2022
465,66,brahmastra part one: shiva,50164785,7839108,15.6,42325677,84.4,2022
466,67,the fabelmans,45620703,17348945,38.0,28271758,62.0,2022
467,68,barbarian,45352337,40842944,90.1,4509393,9.9,2022
468,69,prey for the devil,44658929,19802293,44.3,24856636,55.7,2022
469,70,paws of fury: the legend of hank,42439184,17811382,42.0,24627802,58.0,2022
470,71,the invitation,38036130,25100080,66.0,12936050,34.0,2022
471,72,matilda: the musical,37289659,0,0.0,37289659,100.0,2022
472,73,orphan: first kill,37083743,5413227,14.6,31670516,85.4,2022
473,74,kingdom 2: far and away,34963395,0,0.0,34963395,100.0,2022
474,75,the bob's burgers movie,34148750,31933830,93.5,2214920,6.5,2022
475,76,hunt,33821338,25994,0.0,33795344,99.9,2022
476,77,tad the lost explorer and the emerald tablet,32849430,67599,0.2,32781831,99.8,2022
477,78,bts permission to dance on stage - seoul: live viewing,32600000,6840000,21.0,25760000,79.0,2022
478,79,shin ultraman,32137136,601490,1.9,31535646,98.1,2022
479,80,amsterdam,31245810,14947969,47.8,16297841,52.2,2022
480,81,mrs. harris goes to paris,31182637,10433915,33.5,20748722,66.5,2022
481,82,vikram,29837637,1770000,5.9,28067637,94.1,2022
482,83,the unbearable weight of massive talent,29116320,20300157,69.7,8816163,30.3,2022
483,84,tár,29048571,6773650,23.3,22274921,76.7,2022
484,85,serial (bad) weddings 3,27832384,0,0.0,27832384,100.0,2022
485,86,the 355,27827745,14570455,52.4,13257290,47.6,2022
486,87,the last 10 years,26729106,0,0.0,26729106,100.0,2022
487,88,the night owl,26719364,0,0.0,26719364,100.0,2022
488,89,triangle of sadness,26214659,4608096,17.6,21606563,82.4,2022
489,90,calendar girls,25433615,0,0.0,25433615,100.0,2022
490,91,the kashmir files,24821898,1485000,6.0,23336898,94.0,2022
491,92,hero,24392492,0,0.0,24392492,100.0,2022
492,93,the confidence man jp: episode of the hero,23214581,0,0.0,23214581,100.0,2022
493,94,the witch: part 2 - the other one,23068596,143723,0.6,22924873,99.4,2022
494,95,6/45,22263336,0,0.0,22263336,100.0,2022
495,96,doraemon the movie: nobita's little star wars 2021,22044058,0,0.0,22044058,100.0,2022
496,97,decision to leave,22026067,2179864,9.9,19846203,90.1,2022
497,98,see how they run,21966634,9586237,43.6,12380397,56.4,2022
498,99,ponniyin selvan: part i,21888295,4282000,19.6,17606295,80.4,2022
499,100,devotion,21768133,20511938,94.2,1256195,5.8,2022
500,101,silent parade,21723595,0,0.0,21723595,100.0,2022
501,102,father stu,21592379,20884796,96.7,707583,3.3,2022
502,103,turning red,21521622,1399001,6.5,20122621,93.5,2022
503,104,emergency declaration,21400327,412196,1.9,20988131,98.1,2022
504,105,the amazing maurice,21137115,4303645,20.4,16833470,79.6,2022
505,106,crayon shin-chan: mononoke ninja chinpuden,20617005,0,0.0,20617005,100.0,2022
506,107,monster,20530763,434585,2.1,20096178,97.9,2022
507,108,three thousand years of longing,20282422,8286741,40.9,11995681,59.1,2022
508,109,school of magical animals 2,19683845,45860,0.2,19637985,99.8,2022
509,110,after ever happy,19238073,1072750,5.6,18165323,94.4,2022
510,111,simone: woman of the century,19167164,0,0.0,19167164,100.0,2022
511,112,beast,18911959,0,0.0,18911959,100.0,2022
512,113,broker,18851416,1046899,5.6,17804517,94.4,2022
513,114,godfather,18737287,0,0.0,18737287,100.0,2022
514,115,november,18554715,0,0.0,18554715,100.0,2022
515,116,bhool bhulaiyaa 2,18307258,0,0.0,18307258,100.0,2022
516,117,fragments of the last will,17954691,0,0.0,17954691,100.0,2022
517,118,fall,17363261,7240521,41.7,10122740,58.3,2022
518,119,even if this love disappears from the world tonight,16848229,0,0.0,16848229,100.0,2022
519,120,wonderfully beautiful,16719291,0,0.0,16719291,100.0,2022
520,121,father there is only one 3,16401315,0,0.0,16401315,100.0,2022
521,122,dr. coto's clinic,16062841,0,0.0,16062841,100.0,2022
522,123,radhe shyam,15954804,1860000,11.7,14094804,88.3,2022
523,124,blacklight,15902207,9591094,60.3,6311113,39.7,2022
524,125,operation mincemeat,15621194,0,0.0,15621194,100.0,2022
525,126,maison de retraite,15570823,0,0.0,15570823,100.0,2022
526,127,"utapri movie 2, uta no prince-sama maji love starish tours movie",15569229,0,0.0,15569229,100.0,2022
527,128,bheemla nayak,15243922,0,0.0,15243922,100.0,2022
528,129,bones and all,15234907,7834907,51.4,7400000,48.6,2022
529,130,terrifier 2,15067016,10640105,70.6,4426911,29.4,2022
530,131,firestarter,15039250,9739250,64.8,5300000,35.2,2022
531,132,the wolf of wall street 2022 re-release,15038738,0,0.0,14877539,98.9,2022
532,133,bros,14781867,11628165,78.7,3153702,21.3,2022
533,134,superwho?,14770359,0,0.0,14770359,100.0,2022
534,135,x,14740889,11765309,79.8,2975580,20.2,2022
535,136,the chosen season 3: episode 1 & 2,14679613,14612089,99.5,67524,0.5,2022
536,137,the duke,14233027,1526970,10.7,12700247,89.2,2022
537,138,sarkaru vaari paata,14199018,0,0.0,14199018,100.0,2022
538,139,she said,13944212,5825995,41.8,8118217,58.2,2022
539,140,the legend of maula jatt,13941539,5016493,36.0,8925046,64.0,2022
540,141,bodies bodies bodies,13929670,11446602,82.2,2483068,17.8,2022
541,142,glass onion,13280000,13280000,100.0,0,0.0,2022
542,143,valimai,13276393,0,0.0,13276393,100.0,2022
543,144,memory,13240559,7329043,55.4,5911516,44.6,2022
544,145,moonage daydream,13095781,4218925,32.2,8876856,67.8,2022
545,146,easter sunday,13074255,13013690,99.5,60565,0.5,2022
546,147,living,12377310,3038113,24.5,9339197,75.5,2022
547,148,guglhupfgeschwader,12307072,0,0.0,12307072,100.0,2022
548,149,alienoid,12109608,168309,1.4,11941299,98.6,2022
549,150,laal singh chaddha,12093536,3401324,28.1,8692212,71.9,2022
550,151,that time i got reincarnated as a slime the movie: scarlet bond,11628645,1588491,13.7,10040154,86.3,2022
551,152,till,11498884,9000202,78.3,2498682,21.7,2022
552,153,jug jugg jeeyo,11467726,1033000,9.0,10434726,91.0,2022
553,154,empire of light,11395604,1177577,10.3,10218027,89.7,2022
554,155,the eight mountains,11374298,302456,2.7,11071842,97.3,2022
555,156,bergen,11325405,0,0.0,11325405,100.0,2022
556,157,rise,11252331,0,0.0,11252331,100.0,2022
557,158,men,11152071,7587853,68.0,3564218,32.0,2022
558,159,chickenhare and the hamster of darkness,10885116,0,0.0,10885116,100.0,2022
559,160,warriors of future,10490328,0,0.0,10490328,100.0,2022
560,161,land of legends,10357479,0,0.0,10357479,100.0,2022
561,162,the pirates: the last royal treasure,10258331,0,0.0,10258331,100.0,2022
562,163,vaillante,10143170,0,0.0,10143170,100.0,2022
563,164,table for six,10138355,0,0.0,10138355,100.0,2022
564,165,the beasts,10067896,46105,0.5,10021791,99.5,2022
565,166,smack dab kakha,9995945,0,0.0,9995945,100.0,2022
566,167,f3: fun and frustration,9849193,1195000,12.1,8654193,87.9,2022
567,168,pearl,9847490,9423445,95.7,424045,4.3,2022
568,169,"good luck to you, leo grande",9795364,0,0.0,9795364,100.0,2022
569,170,rheingold,9701747,0,0.0,9701747,100.0,2022
570,171,spider-man: no way home 2022 re-release,9613518,9321593,97.0,291925,3.0,2022
571,172,redeeming love,9464198,9214020,97.4,250178,2.6,2022
572,173,women talking,9276103,5456531,58.8,3819572,41.2,2022
573,174,sword art online the movie: progressive - scherzo of deep night,9071701,0,0.0,9071701,100.0,2022
574,175,aftersun,8598565,1658790,19.3,6939775,80.7,2022
575,176,samrat prithviraj,8568339,0,0.0,8568339,100.0,2022
576,177,life is beautiful,8458639,0,0.0,8458639,100.0,2022
577,178,yolki 9,8385030,0,0.0,8385030,100.0,2022
578,179,don,8287406,0,0.0,8287406,100.0,2022
579,180,shotgun wedding,8277788,0,0.0,8277788,100.0,2022
580,181,vikram vedha,8234166,1589362,19.3,6644804,80.7,2022
581,182,re/member,8166175,0,0.0,8166175,100.0,2022
582,183,rabbit academy: mission eggpossible,8118795,0,0.0,8118795,100.0,2022
583,184,acharya,8048175,832000,10.3,7216175,89.7,2022
584,185,il grande giorno,8021940,0,0.0,8021940,100.0,2022
585,186,the tatta's,8000956,0,0.0,8000956,100.0,2022
586,187,ducobu 4 president,7858171,0,0.0,7858171,100.0,2022
587,188,finnick,7591889,0,0.0,7591889,100.0,2022
588,189,phases of the moon,7564756,0,0.0,7564756,100.0,2022
589,190,777 charlie,7523995,0,0.0,7523995,100.0,2022
590,191,bachchhan paandey,7387882,0,0.0,7387882,100.0,2022
591,192,lesson in murder,7348964,0,0.0,7348964,100.0,2022
592,193,family affairs,7330755,0,0.0,7330755,100.0,2022
593,194,listy do m. 5,7328061,0,0.0,7328061,100.0,2022
594,195,laid-back camp movie,7317913,0,0.0,7317913,100.0,2022
595,196,osomatsusan the movie 2022 re-release,7297522,0,0.0,7297522,100.0,2022
596,197,the new toy,7295051,0,0.0,7295051,100.0,2022
597,198,decibel,7212471,60579,0.8,7151892,99.2,2022
598,199,the kids are alright 2,7187470,0,0.0,7187470,100.0,2022
599,200,my fairy troublemaker,7177868,0,0.0,7177868,100.0,2022
600,1,spider-man: no way home,1910982770,804793477,42.1,1106189293,57.9,2021
601,2,the battle at lake changjin,902548476,342411,0.0,902206065,100.0,2021
602,3,"hi, mom",822009764,0,0.0,822009764,100.0,2021
603,4,no time to die,774153007,160891007,20.8,613262000,79.2,2021
604,5,f9: the fast saga,726229501,173005945,23.8,553223556,76.2,2021
605,6,detective chinatown 3,686257563,0,0.0,686257563,100.0,2021
606,7,venom: let there be carnage,506813864,213550366,42.1,293263498,57.9,2021
607,8,godzilla vs. kong,470116094,100916094,21.5,369200000,78.5,2021
608,9,shang-chi and the legend of the ten rings,432243292,224543292,51.9,207700000,48.1,2021
609,10,sing 2,408402685,162790990,39.9,245611695,60.1,2021
610,11,dune: part one,402127830,108327830,26.9,293800000,73.1,2021
611,12,eternals,402064899,164870234,41.0,237194665,59.0,2021
612,13,black widow,379751655,183651655,48.4,196100000,51.6,2021
613,14,free guy,331526598,121626598,36.7,209900000,63.3,2021
614,15,a quiet place part ii,297372261,160072261,53.8,137300000,46.2,2021
615,16,encanto,256786742,96093622,37.4,160693120,62.6,2021
616,17,cruella,233503234,86103234,36.9,147400000,63.1,2021
617,18,"my country, my parents",221831086,177133,0.0,221653953,99.9,2021
618,19,jungle cruise,220889446,116987516,53.0,103901930,47.0,2021
619,20,the conjuring: the devil made me do it,206431050,65631050,31.8,140800000,68.2,2021
620,21,raging fire,205842393,385305,0.2,205457088,99.8,2021
621,22,ghostbusters: afterlife,204334455,129360575,63.3,74973880,36.7,2021
622,23,chinese doctors,197143218,0,0.0,197143218,100.0,2021
623,24,cliff walkers,181325565,152972,0.0,181172593,99.9,2021
624,25,the suicide squad,168717425,55817425,33.1,112900000,66.9,2021
625,26,jujutsu kaisen 0,166760828,34542754,20.7,132218074,79.3,2021
626,27,space jam: a new legacy,163692228,70592228,43.1,93100000,56.9,2021
627,28,the matrix resurrections,157386805,37686805,23.9,119700000,76.1,2021
628,29,peter rabbit 2: the runaway,153901717,40501717,26.3,113400000,73.7,2021
629,30,house of gucci,153269161,53809574,35.1,99459587,64.9,2021
630,31,a writer's odyssey,150123320,160013,0.1,149963307,99.9,2021
631,32,the boss baby: family business,146745280,57300280,39.0,89445000,61.0,2021
632,33,paw patrol: the movie,144327371,40127371,27.8,104200000,72.2,2021
633,34,tom & jerry,136536687,46536687,34.1,90000000,65.9,2021
634,35,be somebody,132326332,0,0.0,132326332,100.0,2021
635,36,halloween kills,131647155,92002155,69.9,39645000,30.1,2021
636,37,raya and the last dragon,130423032,54723032,42.0,75700000,58.0,2021
637,38,sister,128317206,0,0.0,128317206,100.0,2021
638,39,the king's man,125897478,37176373,29.5,88721105,70.5,2021
639,40,the addams family 2,119815153,56489153,47.1,63326000,52.9,2021
640,41,my love,116720921,86252,0.0,116634669,99.9,2021
641,42,clifford the big red dog,107347356,48947356,45.6,58400000,54.4,2021
642,43,wrath of man,103966489,27466489,26.4,76500000,73.6,2021
643,44,detective conan: the scarlet bullet,95371578,0,0.0,95371578,100.0,2021
644,45,evangelion: 3.0+1.01 thrice upon a time,93882453,810744,0.9,93071709,99.1,2021
645,46,end game,91824961,23149,0.0,91801812,100.0,2021
646,47,old,90146510,48276510,53.6,41870000,46.4,2021
647,48,mortal kombat,84426031,42326031,50.1,42100000,49.9,2021
648,49,boonie bears: the wild life,78132231,0,0.0,78132231,100.0,2021
649,50,candyman,77411570,61186570,79.0,16225000,21.0,2021
650,51,the forever purge,76994245,44539245,57.8,32455000,42.2,2021
651,52,west side story,76016171,38530322,50.7,37485849,49.3,2021
652,53,1921,75159828,0,0.0,75159828,100.0,2021
653,54,hitman's wife's bodyguard,70060492,38014727,54.3,32045765,45.7,2021
654,55,escape room: tournament of champions,65774490,25314753,38.5,40459737,61.5,2021
655,56,belle,64679830,4018313,6.2,60661517,93.8,2021
656,57,ron's gone wrong,60692022,23009270,37.9,37682752,62.1,2021
657,58,cloudy mountain,58348836,0,0.0,58348836,100.0,2021
658,59,avatar 2021 re-release,57995770,0,0.0,57995770,100.0,2021
659,60,nobody,57510518,27568035,47.9,29942483,52.1,2021
660,61,new gods: nezha reborn,56088478,0,0.0,56088478,100.0,2021
661,62,upcoming,54300000,0,0.0,54300000,100.0,2021
662,63,don't breathe 2,53785551,32712950,60.8,21072601,39.2,2021
663,64,man in love,52946097,0,0.0,52946097,100.0,2021
664,65,break through the darkness,52700000,0,0.0,52700000,100.0,2021
665,66,schemes in antiques,51637422,36501,0.0,51600921,99.9,2021
666,67,luca,51074773,1324302,2.6,49750471,97.4,2021
667,68,belfast,49158709,9250870,18.8,39907839,81.2,2021
668,69,my hero academia: world heroes' mission,46940541,12271658,26.1,34668883,73.9,2021
669,70,the french dispatch,46333545,16124375,34.8,30209170,65.2,2021
670,71,in the heights,45175167,29975167,66.4,15200000,33.6,2021
671,72,love will tear us apart,45060290,0,0.0,45060290,100.0,2021
672,73,spirit untamed,42717215,17716215,41.5,25001000,58.5,2021
673,74,resident evil: welcome to raccoon city,41914915,17000612,40.6,24914303,59.4,2021
674,75,spiral,40618920,23216862,57.2,17402058,42.8,2021
675,76,snake eyes,40064325,28264325,70.5,11800000,29.5,2021
676,77,tokyo revengers,39714624,0,0.0,39714624,100.0,2021
677,78,nightmare alley,39629195,11338107,28.6,28291088,71.4,2021
678,79,king richard,39529285,15129285,38.3,24400000,61.7,2021
679,80,nomadland,39458207,3700000,9.4,35758207,90.6,2021
680,81,arashi anniversary tour 5 x 20 film: record of memories,38052695,0,0.0,38052695,100.0,2021
681,82,the yinyang master,37690000,0,0.0,37690000,100.0,2021
682,83,rurouni kenshin: final chapter part i - the final,36964978,0,0.0,36964978,100.0,2021
683,84,the door lock,36100000,0,0.0,36100000,100.0,2021
684,85,we made a beautiful bouquet,35042879,0,0.0,35042879,100.0,2021
685,86,malignant,34891791,13391791,38.4,21500000,61.6,2021
686,87,licorice pizza,33276075,17318007,52.0,15958068,48.0,2021
687,88,respect,32882823,24278399,73.8,8604424,26.2,2021
688,89,big red envelope,32800000,0,0.0,32800000,100.0,2021
689,90,masquerade night,32287400,0,0.0,32287400,100.0,2021
690,91,once upon a time in hong kong,32218874,0,0.0,32218874,100.0,2021
691,92,home sweet home,32178677,0,0.0,32178677,100.0,2021
692,93,the little things,30842746,15342746,49.7,15500000,50.3,2021
693,94,the unholy,30832137,15532137,50.4,15300000,49.6,2021
694,95,the last duel,30552111,10853945,35.5,19698166,64.5,2021
695,96,escape from mogadishu,29902716,346271,1.2,29556445,98.8,2021
696,97,master,28692230,0,0.0,28692230,100.0,2021
697,98,the last warrior: root of evil,28357398,0,0.0,28357398,100.0,2021
698,99,the last warrior: a messenger of darkness,27052365,0,0.0,27052365,100.0,2021
699,100,american underdog,26514814,26514814,100.0,0,0.0,2021
700,101,chaos walking,26508132,13287908,50.1,13220224,49.9,2021
701,102,the courier,26001227,6613432,25.4,19387795,74.6,2021
702,103,spencer,25246967,7086632,28.1,18160335,71.9,2021
703,104,parallel mothers,23099858,2297501,9.9,20802357,90.1,2021
704,105,the marksman,23076711,15566093,67.5,7510618,32.5,2021
705,106,99.9 criminal lawyer: the movie,23055069,0,0.0,23055069,100.0,2021
706,107,last night in soho,22957625,10127625,44.1,12830000,55.9,2021
707,108,the day we lit up the sky,22500000,0,0.0,22500000,100.0,2021
708,109,school of magical animals,22136896,288414,1.3,21848482,98.7,2021
709,110,kaamelott: first installment,21979122,188000,0.9,21791122,99.1,2021
710,111,after we fell,21753705,2170750,10.0,19582955,90.0,2021
711,112,rurouni kenshin: final chapter part ii - the beginning,21318560,0,0.0,21318560,100.0,2021
712,113,wish dragon,21120000,0,0.0,21120000,100.0,2021
713,114,crayon shin-chan: shrouded in mystery! the flowers of tenkazu academy,20752104,0,0.0,20752104,100.0,2021
714,115,stillwater,19754272,14465535,73.2,5288737,26.8,2021
715,116,the wolf and the lion,19510578,2072173,10.6,17438405,89.4,2021
716,117,les tuche 4,19259766,0,0.0,19259766,100.0,2021
717,118,dear evan hansen,19133454,15002646,78.4,4130808,21.6,2021
718,119,those who wish me dead,19107200,7407200,38.8,11700000,61.2,2021
719,120,the pioneer,18900000,0,0.0,18900000,100.0,2021
720,121,the green knight,18887953,17173321,90.9,1714632,9.1,2021
721,122,antlers,18867659,10619670,56.3,8247989,43.7,2021
722,123,sinkhole,18816801,0,0.0,18816801,100.0,2021
723,124,mobile suit gundam: hathaway,18731309,0,0.0,18731309,100.0,2021
724,125,the stronghold,18066143,0,0.0,18066143,100.0,2021
725,126,"dad, i'm sorry",17480489,350000,2.0,17130489,98.0,2021
726,127,gintama: the final,17252960,0,0.0,17252960,100.0,2021
727,128,railway heroes,17223704,0,0.0,17223704,100.0,2021
728,129,your turn to kill,16511822,0,0.0,16511822,100.0,2021
729,130,cry macho,16510734,10310734,62.4,6200000,37.6,2021
730,131,reminiscence,16400193,3900193,23.8,12500000,76.2,2021
731,132,legend no. 17,16096860,0,0.0,16096860,100.0,2021
732,133,upon the magic roads,15990882,0,0.0,15990882,100.0,2021
733,134,harry potter and the sorcerer's stone 2021 re-release,15695755,799342,5.1,14708453,93.7,2021
734,135,the dry,15576286,364237,2.3,15212049,97.7,2021
735,136,the night house,15437703,7100581,46.0,8337122,54.0,2021
736,137,drive my car,15357339,2352240,15.3,13005099,84.7,2021
737,138,minari,15288578,3110580,20.3,12177998,79.7,2021
738,139,something about love,15204017,0,0.0,15204017,100.0,2021
739,140,anita,15017470,556632,3.7,14460838,96.3,2021
740,141,and so the baton is passed,14403588,0,0.0,14403588,100.0,2021
741,142,the tomorrow war,14400000,0,0.0,14400000,100.0,2021
742,143,sword art online: progressive - aria of a starless night,14032747,1050000,7.5,12982747,92.5,2021
743,144,christmas with the chosen: the messengers,13728000,13728000,100.0,0,0.0,2021
744,145,eiffel,13573923,444814,3.3,13129109,96.7,2021
745,146,oss 117: from africa with love,13457801,0,0.0,13457801,100.0,2021
746,147,hostage: missing celebrity,13174292,0,0.0,13174292,100.0,2021
747,148,vakeel saab,13056490,0,0.0,13056490,100.0,2021
748,149,the many saints of newark,13037403,8237403,63.2,4800000,36.8,2021
749,150,the monkey king: reborn,13017088,0,0.0,13017088,100.0,2021
750,151,no escapes,12916151,0,0.0,12916151,100.0,2021
751,152,the bodin's in the land of smile,12872253,0,0.0,12872253,100.0,2021
752,153,the worst person in the world,12687507,3034775,23.9,9652732,76.1,2021
753,154,character,12628017,0,0.0,12628017,100.0,2021
754,155,on your mark,12100000,0,0.0,12100000,100.0,2021
755,156,on the line,12058986,0,0.0,12058986,100.0,2021
756,157,stand by me,11900000,0,0.0,11900000,100.0,2021
757,158,the fable: the killer who doesn't kill,11325545,0,0.0,11325545,100.0,2021
758,159,what did you eat yesterday?,11320893,0,0.0,11320893,100.0,2021
759,160,aline,11149943,667815,6.0,10482128,94.0,2021
760,161,krack,10435375,0,0.0,10435375,100.0,2021
761,162,realm of terracotta,10363914,0,0.0,10363914,100.0,2021
762,163,kaiserschmarrndrama,10357720,0,0.0,10357720,100.0,2021
763,164,"caution, hazardous wife: the movie",10356359,0,0.0,10356359,100.0,2021
764,165,detective conan: the scarlet alibi,10308627,0,0.0,10308627,100.0,2021
765,166,never stop,10224935,0,0.0,10224935,100.0,2021
766,167,ainbo,10172403,0,0.0,10172403,100.0,2021
767,168,eiga sumikkogurashi: aoi tsukiyo no mahô no ko,9742510,0,0.0,9742510,100.0,2021
768,169,black box,9738741,0,0.0,9738741,100.0,2021
769,170,the soul,9600000,0,0.0,9600000,100.0,2021
770,171,¡a todo tren! destino asturias,9544171,0,0.0,9544171,100.0,2021
771,172,baragaki: unbroken samurai,9481437,0,0.0,9481437,100.0,2021
772,173,dad,9267397,0,0.0,9267397,100.0,2021
773,174,the lord of the rings: the fellowship of the ring 2021 re-release,8990599,0,0.0,8377569,93.2,2021
774,175,all about my mother,8900000,0,0.0,8900000,100.0,2021
775,176,the eleventh chapter,8844997,0,0.0,8844997,100.0,2021
776,177,the medium,8826689,0,0.0,8826689,100.0,2021
777,178,the vault,8803864,0,0.0,8803864,100.0,2021
778,179,kaguya-sama: love is war,8794981,0,0.0,8794981,100.0,2021
779,180,moonbound,8749542,0,0.0,8749542,100.0,2021
780,181,the protégé,8737253,7446823,85.2,1290430,14.8,2021
781,182,lost illusions,8635184,126391,1.5,8508793,98.5,2021
782,183,agent backkom: king's bear,8619446,0,0.0,8619446,100.0,2021
783,184,pil's adventures,8567345,0,0.0,8567345,100.0,2021
784,185,honey lemon soda,8441488,0,0.0,8441488,100.0,2021
785,186,delicious,8371523,0,0.0,8371523,100.0,2021
786,187,i don't have any money left in my retirement account,8204616,0,0.0,8204616,100.0,2021
787,188,girls to buy,8177284,0,0.0,8177284,100.0,2021
788,189,green snake,8170000,0,0.0,8170000,100.0,2021
789,190,new happy dad and son 4,8070000,0,0.0,8070000,100.0,2021
790,191,sunny sisters,7880000,0,0.0,7880000,100.0,2021
791,192,contra,7762797,0,0.0,7762797,100.0,2021
792,193,hard hit,7658021,0,0.0,7658021,100.0,2021
793,194,little canned men,7600000,0,0.0,7600000,100.0,2021
794,195,pushpa: the rise - part 1,7592374,1320000,17.4,6272374,82.6,2021
795,196,the mauritanian,7527030,836536,11.1,6690494,88.9,2021
796,197,the ice road,7502846,0,0.0,7502846,100.0,2021
797,198,judas and the black messiah,7478009,5478009,73.3,2000000,26.7,2021
798,199,love letter 2021 re-release,7400000,0,0.0,7400000,100.0,2021
799,200,signal: the movie,7388603,0,0.0,7388603,100.0,2021
800,1,demon slayer: kimetsu no yaiba - the movie: mugen train,473230408,49505008,10.5,423725400,89.5,2020
801,2,the eight hundred,461421559,372755,0.0,461048804,99.9,2020
802,3,bad boys for life,426505244,206305244,48.4,220200000,51.6,2020
803,4,"my people, my homeland",422390820,0,0.0,422390820,100.0,2020
804,5,tenet,365304105,58504105,16.0,306800000,84.0,2020
805,6,sonic the hedgehog,319715683,148974665,46.6,170741018,53.4,2020
806,7,dolittle,251410631,77047065,30.6,174363566,69.4,2020
807,8,jiang ziya,240646355,214670,0.0,240431685,99.9,2020
808,9,a little red flower,216000000,0,0.0,216000000,100.0,2020
809,10,the croods: a new age,215905815,58568815,27.1,157337000,72.9,2020
810,11,birds of prey,205358461,84158461,41.0,121200000,59.0,2020
811,12,shock wave 2,198921659,0,0.0,198921659,100.0,2020
812,13,wonder woman 1984,169601036,46801036,27.6,122800000,72.4,2020
813,14,the sacrifice,161047608,0,0.0,161047608,100.0,2020
814,15,the invisible man,144492724,70410000,48.7,74082724,51.3,2020
815,16,onward,141940042,61555145,43.4,80384897,56.6,2020
816,17,warm hug,129240236,0,0.0,129240236,100.0,2020
817,18,soul,121903885,946154,0.8,120957731,99.2,2020
818,19,the call of the wild,111166669,62342368,56.1,48824301,43.9,2020
819,20,caught in time,80543319,0,0.0,80543319,100.0,2020
820,21,mulan,69965374,0,0.0,69965374,100.0,2020
821,22,the yin-yang master: dream of eternity,68000000,0,0.0,68000000,100.0,2020
822,23,stand by me doraemon 2,65201374,0,0.0,65201374,100.0,2020
823,24,the rescue,64237554,18797,0.0,64218757,100.0,2020
824,25,love you forever,60670799,0,0.0,60670799,100.0,2020
825,26,greenland,52300000,0,0.0,52300000,100.0,2020
826,27,tolo tolo,52186426,0,0.0,52186426,100.0,2020
827,28,vanguard,50866901,793525,1.6,50073376,98.4,2020
828,29,fantasy island,49447308,27309289,55.2,22138019,44.8,2020
829,30,trolls world tour,49276818,450000,0.9,48826818,99.1,2020
830,31,the new mutants,49169594,23852659,48.5,25316935,51.5,2020
831,32,after we collided,47990414,2386483,5.0,45603931,95.0,2020
832,33,"from today, it's my turn: the movie",47895887,0,0.0,47895887,100.0,2020
833,34,tanhaji: the unsung warrior,45221814,0,0.0,45221814,100.0,2020
834,35,unhinged,44331465,20831465,47.0,23500000,53.0,2020
835,36,the end of endless love,43950000,0,0.0,43950000,100.0,2020
836,37,the war with grandpa,43387638,21277892,49.0,22109746,51.0,2020
837,38,peninsula,42698327,1231407,2.9,41466920,97.1,2020
838,39,monster hunter,42145959,15162470,36.0,26983489,64.0,2020
839,40,underwater,40882928,17291078,42.3,23591850,57.7,2020
840,41,bloodshot,39861118,12561824,31.5,27299294,68.5,2020
841,42,sarileru neekevvaru,37389889,821000,2.2,36568889,97.8,2020
842,43,the untold tale of the three kingdoms,36747486,0,0.0,36747486,100.0,2020
843,44,the confidence man jp: princess,36109913,0,0.0,36109913,100.0,2020
844,45,the man standing next,34664900,113527,0.3,34551373,99.7,2020
845,46,my mom is a character 3,34360029,0,0.0,34360029,100.0,2020
846,47,doraemon the movie: nobita's new dinosaur,34218525,0,0.0,34218525,100.0,2020
847,48,deliver us from evil,33718703,0,0.0,33718703,100.0,2020
848,49,harry potter and the sorcerer's stone 2020 re-release,31503136,0,0.0,31501815,100.0,2020
849,50,honest thief,31220247,14163574,45.4,17056673,54.6,2020
850,51,like a boss,30399490,22169514,72.9,8229976,27.1,2020
851,52,the witches,29303571,203571,0.7,29100000,99.3,2020
852,53,bath buddy,28700000,0,0.0,28700000,100.0,2020
853,54,scoob!,28588425,2188425,7.7,26400000,92.3,2020
854,55,ala vaikunthapurramuloo,28477890,0,0.0,28477890,100.0,2020
855,56,emma.,25932444,10055355,38.8,15877089,61.2,2020
856,57,leap,25818882,83074,0.3,25735808,99.7,2020
857,58,gravity 2020 re-release,24857278,0,0.0,24857244,100.0,2020
858,59,the father,24048935,2122771,8.8,21920547,91.1,2020
859,60,poupelle of chimney town,22715146,0,0.0,22715146,100.0,2020
860,61,gretel & hansel,22304357,15347654,68.8,6956703,31.2,2020
861,62,stigmatized properties,21276720,0,0.0,21276720,100.0,2020
862,63,pokémon the movie: secrets of the jungle,21097921,0,0.0,21097921,100.0,2020
863,64,the photograph,20690779,20578185,99.5,112594,0.5,2020
864,65,threads - our tapestry of love,20474270,0,0.0,20474270,100.0,2020
865,66,brahms: the boy ii,20311536,12611536,62.1,7700000,37.9,2020
866,67,violet evergarden: the movie,20302668,0,0.0,20302668,100.0,2020
867,68,interstellar 2020 re-release,19990000,0,0.0,19990000,100.0,2020
868,69,ice 2,19788995,0,0.0,19788995,100.0,2020
869,70,soul snatcher,19561221,0,0.0,19561221,100.0,2020
870,71,the turning,19428166,15472775,79.6,3955391,20.4,2020
871,72,fate/stay night [heaven's feel] iii. spring song,19252497,200000,1.0,19052497,99.0,2020
872,73,promising young woman,18854166,6460965,34.3,12393201,65.7,2020
873,74,takizawa enbujo zero,18091395,0,0.0,18091395,100.0,2020
874,75,freaky,18073433,9030855,50.0,9042578,50.0,2020
875,76,the promised neverland,17710977,0,0.0,17710977,100.0,2020
876,77,kaiji: final game,17645779,0,0.0,17645779,100.0,2020
877,78,hitman: agent jun,17601351,0,0.0,17601351,100.0,2020
878,79,digimon adventure: last evolution kizuna,17361009,0,0.0,17361009,100.0,2020
879,80,bye bye morons,16955924,0,0.0,16955924,100.0,2020
880,81,baaghi 3,16726510,721439,4.3,16005071,95.7,2020
881,82,i still believe,16069730,9868521,61.4,6201209,38.6,2020
882,83,the way back,15490514,13590514,87.7,1900000,12.3,2020
883,84,father there is only one 2,15373181,0,0.0,15373181,100.0,2020
884,85,the personal history of david copperfield,14399270,1876298,13.0,12522972,87.0,2020
885,86,nightlife,14308789,0,0.0,14308789,100.0,2020
886,87,pawn,14193957,0,0.0,14193957,100.0,2020
887,88,the post 2020 re-release,13995207,0,0.0,13995207,100.0,2020
888,89,#alive,13432212,0,0.0,13432212,100.0,2020
889,90,howling village,13394556,0,0.0,13394556,100.0,2020
890,91,come play,13182254,10475990,79.5,2706264,20.5,2020
891,92,samjin company english class,12761386,0,0.0,12761386,100.0,2020
892,93,another round,12745392,0,0.0,12742455,100.0,2020
893,94,news of the world,12668325,12668325,100.0,0,0.0,2020
894,95,collectors,12640113,0,0.0,12640113,100.0,2020
895,96,shinchan: crash! scribble kingdom and almost four heroes,12221804,0,0.0,12221804,100.0,2020
896,97,ducobu 3,12157793,0,0.0,12157793,100.0,2020
897,98,the asadas,11888743,0,0.0,11888743,100.0,2020
898,99,wotakoi: love is hard for otaku,11702371,0,0.0,11702371,100.0,2020
899,100,bigfoot family,11128253,0,0.0,11128253,100.0,2020
900,101,30 jours max,11007713,0,0.0,11007713,100.0,2020
901,102,the voice of sin,10983063,0,0.0,10983063,100.0,2020
902,103,two by two: overboard!,10885076,0,0.0,10885076,100.0,2020
903,104,let him go,10835686,9358025,86.4,1477661,13.6,2020
904,105,one second,10791301,0,0.0,10791301,100.0,2020
905,106,me contro te - il film: la vendetta del signor s,10779891,0,0.0,10779891,100.0,2020
906,107,impractical jokers: the movie,10691091,10691091,100.0,0,0.0,2020
907,108,honest candidate,10597464,0,0.0,10597464,100.0,2020
908,109,the hunt,10550350,5812500,55.1,4737850,44.9,2020
909,110,street dancer 3d,10339127,0,0.0,10339127,100.0,2020
910,111,my spy,10200000,0,0.0,10200000,100.0,2020
911,112,100% wolf,9775522,658764,6.7,9116758,93.3,2020
912,113,stolen identity 2,9687188,0,0.0,9687188,100.0,2020
913,114,inception 10th anniversary re-release,9581100,0,0.0,9581100,100.0,2020
914,115,10 days with dad,9472077,2359,0.0,9469718,100.0,2020
915,116,secret zoo,9471940,0,0.0,9471940,100.0,2020
916,117,365 days,9458590,0,0.0,9458590,100.0,2020
917,118,okay madam,9433525,0,0.0,9433525,100.0,2020
918,119,l'appel de la forêt,9317347,0,0.0,9317347,100.0,2020
919,120,the closet,9189552,0,0.0,9189552,100.0,2020
920,121,malasaña 32,8968845,0,0.0,8968845,100.0,2020
921,122,break the silence: the movie,8954345,0,0.0,8954345,100.0,2020
922,123,i hate summer,8926071,0,0.0,8926071,100.0,2020
923,124,downhill,8899195,8287061,93.1,612134,6.9,2020
924,125,les blagues de toto,8859185,0,0.0,8859185,100.0,2020
925,126,the secret garden,8721243,0,0.0,8721243,100.0,2020
926,127,war of the eltis,8613864,0,0.0,8613864,100.0,2020
927,128,malang,8399765,0,0.0,8399765,100.0,2020
928,129,your eyes tell,8020474,0,0.0,8020474,100.0,2020
929,130,"my donkey, my lover & i",7974769,152184,1.9,7821615,98.1,2020
930,131,ai amok,7932191,0,0.0,7932191,100.0,2020
931,132,the lost prince,7837980,0,0.0,7837980,100.0,2020
932,133,antebellum,7792716,0,0.0,7792716,100.0,2020
933,134,the marriage escape,7760946,0,0.0,7760946,100.0,2020
934,135,spirited away studio ghibli fest 2020,7732697,0,0.0,7732435,100.0,2020
935,136,princess mononoke studio ghibli fest 2020,7673800,0,0.0,7673207,100.0,2020
936,137,the heist of the century,7627100,0,0.0,7627100,100.0,2020
937,138,de gaulle,7501454,0,0.0,7501454,100.0,2020
938,139,fukushima 50,7494243,0,0.0,7494243,100.0,2020
939,140,the best years,7358771,0,0.0,7358771,100.0,2020
940,141,bohemian rhapsody 2020 re-release,7158262,240000,3.4,6914052,96.6,2020
941,142,the (un)perfect guy,7154649,0,0.0,7154649,100.0,2020
942,143,spycies,7128952,0,0.0,7128952,100.0,2020
943,144,back to the wharf,7090000,0,0.0,7090000,100.0,2020
944,145,adu,7085946,0,0.0,7085946,100.0,2020
945,146,fatale,7031289,6306897,89.7,724392,10.3,2020
946,147,dragon rider,6977378,0,0.0,6977378,100.0,2020
947,148,jim button and the wild 13,6933267,0,0.0,6933267,100.0,2020
948,149,psy 3: w imie zasad,6725146,0,0.0,6725146,100.0,2020
949,150,blood moon party,6709383,0,0.0,6709383,100.0,2020
950,151,innocence,6688330,0,0.0,6659968,99.6,2020
951,152,shubh mangal zyada saavdhan,6574905,0,0.0,6574905,100.0,2020
952,153,chhapaak,6532100,604334,9.3,5927766,90.7,2020
953,154,"love me, love me not",6494241,0,0.0,6494241,100.0,2020
954,155,hammamet,6434874,0,0.0,6434874,100.0,2020
955,156,lindenberg! mach dein ding,6404964,0,0.0,6404964,100.0,2020
956,157,midnight swan,6397065,0,0.0,6397065,100.0,2020
957,158,nausicaä of the valley of the wind 2020 re-release,6395525,0,0.0,6395525,100.0,2020
958,159,simply black,6323750,0,0.0,6323750,100.0,2020
959,160,my boyfriend's meds,6292780,2971116,47.2,3321664,52.8,2020
960,161,bill & ted face the music,6274027,3439660,54.8,2834367,45.2,2020
961,162,hotel belgrade,6189882,0,0.0,6189882,100.0,2020
962,163,how to be a good wife,6033430,0,0.0,6033430,100.0,2020
963,164,the legacy of dr. death: black file,6024046,0,0.0,6024046,100.0,2020
964,165,a piece of cake,6008448,0,0.0,6008448,100.0,2020
965,166,the rhythm section,5989583,5437971,90.8,551612,9.2,2020
966,167,how i became a gangster,5975729,0,0.0,5975729,100.0,2020
967,168,the innocent,5929392,22549,0.4,5906843,99.6,2020
968,169,twiceborn,5880157,11527,0.2,5868630,99.8,2020
969,170,the royal bride,5830719,0,0.0,5830719,100.0,2020
970,171,beasts clawing at straws,5796059,0,0.0,5796059,100.0,2020
971,172,last letter,5663972,0,0.0,5663972,100.0,2020
972,173,yowamushi pedal: the movie 2020 re-release,5624218,0,0.0,5624218,100.0,2020
973,174,klassikokkutulek 2: pulmad ja matused,5543147,0,0.0,5543147,100.0,2020
974,175,mama weed,5461144,29151,0.5,5431993,99.5,2020
975,176,divorce club,5316313,0,0.0,5316313,100.0,2020
976,177,cats & dogs 3: paws unite,5300000,0,0.0,5300000,100.0,2020
977,178,cindy la regia,5222322,0,0.0,5222322,100.0,2020
978,179,run,5184368,0,0.0,5184368,100.0,2020
979,180,love aaj kal,5120794,0,0.0,5120794,100.0,2020
980,181,masked ward,5107013,0,0.0,5107013,100.0,2020
981,182,ayyappanum koshiyum,5088713,0,0.0,5088713,100.0,2020
982,183,baba parasi,5084342,0,0.0,5084342,100.0,2020
983,184,die känguru-chroniken,5081127,0,0.0,5081127,100.0,2020
984,185,the real exorcist,5035830,0,0.0,5035830,100.0,2020
985,186,mayday,5011408,0,0.0,5011408,100.0,2020
986,187,bheeshma,4997080,0,0.0,4997080,100.0,2020
987,188,made in abyss: dawn of the deep soul,4971635,0,0.0,4971635,100.0,2020
988,189,godai - the wunderkind,4948225,0,0.0,4948225,100.0,2020
989,190,military wives,4890505,0,0.0,4890505,100.0,2020
990,191,panga,4886124,582720,11.9,4303404,88.1,2020
991,192,the tales for old and young,4853143,0,0.0,4853143,100.0,2020
992,193,streltsov,4850073,0,0.0,4850073,100.0,2020
993,194,persian lessons,4849240,0,0.0,4849240,100.0,2020
994,195,the spongebob movie: sponge on the run,4810790,4810790,100.0,0,0.0,2020
995,196,the empty man,4796993,2992948,62.4,1804045,37.6,2020
996,197,the vets,4788826,0,0.0,4788826,100.0,2020
997,198,the broken hearts gallery,4781389,4067442,85.1,713947,14.9,2020
998,199,gladiator 20th anniversary,4780585,0,0.0,4780585,100.0,2020
999,200,intruder,4751103,0,0.0,4751103,100.0,2020
